 9  2   12          4 2 4       6  6  6      8 1    14       13   
9     1           11 4    14     6  6        8           14   
 9   1 13       1     11          6          8         14 14 14  
   14 13       4      4  5              1     13  6          
            4  10   14 5  5        9 3          15       14    
4   10   11       8     10 5 10    9    3 10 3     13 7   12       5    
  10       1        10  10      9     3            15  15   5   
  10           14 3  10   4                        15 9  2 11   
   10        2 13 5 14  4                       14 1      4 7 6  
        11 15   1 14   9       3    3           14 1  1  7 7     6 
    13        7 3 5        3      3                5   9   
             8     1       8  3             8  8   11  4   
            12  12  8   15 14 14 9   8     7   7      11  5   7  8   4 
           6  12       15    8 12          5     11  3     8   
         13 6     10       14 13   12  12        6       3     5  
        13       3 10  14   14       13         12         10 7 4 8 
   11           3 10    14 4   10     15 10    14   11   9  11 6    7 9  4 
11  11  11      14     14       10     3       4        14      15  
 11 12 11     14   8  15   10  2  2            2         13         
  11 12 11     5 10  15  15   10  2   6         2  2 14      2  9        
  3 11 12 2   5  15   15        15 9       4 3  5 14 12      13  5       2 
 3 11     1         11     3 15     3    12  12               2  
       2        2   3  7 15 3  13  3     7 12             4    2 
5  6     4             2 10     8   1  12 6 12 13  15 2   7     5 5  13  
 2      12          10  9  2     12 8    7    2  7  9 9     9  13   
2      12            12    5   12 8  11    7  2  5  9   9     9    
10  3   12   4   9      9              7  7    8  12  5    2    10 
    12   14     9    5    13 9         7  7   11    13 6  5 15 8    2 11 
  5 2  12    10    14     15  9        4     10 11    15 4       6 2   
7  9 6          8    14      11        7 10 1 13   15           9  
          15  5 12 8   7 4    11  3  1  10 14      15 13      9    15    
1    6      9  4 5  2 8       13  13  10  7 15   12  13  3          9   
 7  5  9  13       14         1  14 3        6    2  12          
6  14  5  9  7             12   1     13        1   3     14     
5      3             8 10    1 8      14 9    1  1 1           
 5    4        6     1 6 5    8  12    2  13 9  9   11  1  7   7   6  
1   12 15               1 8          10       11 13    4       1 
 1  10  8   13  13    4   8                   3    14 7  15     1  
  6 2     14 13     11         12     6         3   4    15   1  15 
15  2  6 11  6   13      15 9         12 8  6 14   7  15     3         1 
        15         11       4      3  7    12              
         15   8    11  11  12           7 9 5 11 2            5  8 
9       4    5      11    8 13        5     13               
15      6      1 15   2  12 3     6          13  7   4           
      1  15  5    8  3 7                     7   8         
10 13    1  11   6 5    11  3     10 7      6      3     8  8  13      
13 5    10      4           15 2     7 13     3       8  8   6    
  4 10            7       3    11   12   5      1    8   10   9 10 
  10 4  1         7  6  6 2            4    13  1  1          2 
 11 4  14   4        6  6  7       6 4   4  4  2  15 12 1          2  
