11   2   12 3          2   1     6    6       1 4 12  14       13  14 
     1            4  11  14       6  7      8       6    14   
 9    13       1     11        10  6               8     14   
  14 14 13   14    4   11   4 4    1           1     13  6  8        
   15    10  9     10   14 5  5        9 3  10    10    15     12  14    
4      11      9 8           9 11   3 10    11  13 7  8 12       5    
  10       1   6       10      9     3    3     12   15        
  10   12     13   14 3  10   4   1   4     3          10    9  2 11   
   2        2 13 5   4 1           7    15              4 7 6  
   2 8 2   11 15   1 14   9       3               14   1 15 7 7      
    13      5  7 3 5       1             4          5   9 8  
             8     1       8  3             8  8 6  11  4   
  6      3    12    8    14 14 9   8     7   7        5   7  8   4 
               7     15    8 12          5     11 13      8   
         13 6       6      13     12        6       3 3  15  5  
   3            3 10     14       13         12         10 7 4 8 
             15  2    14 4        15 10    14   11   9  11 6   12  9   
   9 11      14     14       10   2 4 3   5  9  4        14 5     15  
 15 12      14   8     10  2  2   14     2         13    13  3     7  
   12    3   10 12   15 6    10   6         2  2       2  9        
   11  2 13  5  15  12 15         9       4 3  5 14 12      13  5   1     
 3      1         11         4  3       1              2  
       2        2   3  7 15   13       7              4     
5  6     4  14           2 10  3  5    1  12   13  15 2   7 10    5 5   6 
 2    8  12 3         10  9  2     12 8     8   2  7  9 9     9  13   
 10    4      5       12    5      11    7    5              
  3   10  8 4         9      11 11  3  9         8  12      2  9  10 
  1  12   14     9 12   5    13      9    7         13 6 9 5 15 8     11 
  5 2      10 5   14     15  9        4     10 11  15   4     15  6 2   
7  9 6   14    11   8    14      11       15 7  1 13   15           9  
          15  5 12   1 7 4      3  1  10 14    12  15 13      9    15    
1    6      9  4   2 8       13  13    7 15   12              9  15 
 7    9  13 12     3 14           14 3        6    2  12          
6  14  5    7             12   1     13       1  6 2 3     14    8 
  5    3          10   8 10    1       14 9    1  1 1           
12     4        6      6 5    8  12      13   9   11    7   7   6  
  10 12 15               1 8         2 10       11 13    4        
 1  10  8   13  13    4   8                       14 7       1  
  6 2     14      11     11    12     6   8      3   4    15    1 15 
15    6 11  6         15 9        7 12 8   14 7  7  15     3          
                     11   4      3      12     5         
         15   8      11  12           7 9 5 11 2            5  8 
9 15     13 4    5          8 13        5     13               
      6    7  1 15   2  12 3     6    1  5   11   7   4   11        
        15   14   8  3 7                     7   8   6      
10 13    1  11   6 5 10 2  11     5  10 7      6              1 13      
 5    10      4           15 2     7 13     3         8   6  3  
1   10    9      3  7      11 3     13  12   5      1       10  7 9 10 
   4  1          11 6 10  2      11     4     13              2 
 11   14   4        13          11 6 4     4  2  15 12 1    2       12 
